اا	ا
ببب	بب
پپپ	پپ
تت	ت
خخ	خ
دد	د
رر	ر
ششش	شش
طط	ط
زز	ز
عع	ع
فف	ف
گگگ	گگ
ککک	کک
لل	ل
ممم	مم
نن	ن
وو	و
هه	ه
ییی	یی
عالیی	عالی
خییلی	خیلی
خیلیی	خیلی
ببود	بود
بسار	بسیار
معرککه	معرکه
مززخرف	مزخرف
مزخخرف	مزخرف
خووب	خوب
خوبب	خوب
عاالی	عالی